what does jamaican people speak	jamaican	jamaican
what did james k polk do before he was president	james k polk	james k polk
who plays ken barlow in coronation street	ken barlow	coronation street
where is jamarcus russell from	jamarcus russell	jamarcus russell
where was george washington carver from	george washington carver	george washington carver
what else did ben franklin invent	ben franklin	ben franklin
who was richard nixon married to	richard nixon	richard nixon
who is governor of ohio 2011	governor of ohio	ohio
who was vice president after kennedy died	kennedy	kennedy
where is the fukushima daiichi nuclear plant located	fukushima daiichi nuclear plant located	fukushima daiichi nuclear plant
what countries are part of the uk	countries are part of	the uk
what is my timezone in louisiana	louisiana	louisiana
what did st augustine do	st augustine	augustine do
who is keyshia cole dad	keyshia cole	keyshia cole
what kind government does egypt have	egypt	egypt
what town was martin luther king assassinated in	martin luther king	martin luther king
where did edgar allan poe died	edgar allan poe	edgar allan poe
what to do today in atlanta with kids	atlanta	atlanta
what electorate does anna bligh represent	anna bligh	anna bligh
what timezone is sweden	sweden	sweden
who did cam newton sign with	cam newton	cam newton
what county is frederick md in	frederick	frederick
what highschool did harper lee go to	harper lee	harper lee
what timezone is utah in	utah	utah
who did george w. bush run against for the second term	george w. bush	george w. bush
who is niall ferguson 's wife	niall ferguson	niall ferguson
where is the galapagos islands located on a world map	galapagos islands	galapagos islands
what are the songs that justin bieber wrote	justin bieber	justin bieber
what did george clemenceau do	george clemenceau	george clemenceau
what is the state flower of arizona	arizona	arizona
where was rihanna born and raised	rihanna	rihanna
where george lopez was born	george lopez	george lopez
where are samsung based	samsung	samsung
what did the islamic people believe in	islamic	islamic
what did george orwell died of	george orwell	george orwell
what country did adolf hitler control	adolf hitler	adolf hitler
who is michael buble	michael buble	michael buble
what county is kansas city kansas	kansas city	kansas city
who did jackie robinson first play for	jackie robinson	jackie robinson
where did eleanor roosevelt die	eleanor roosevelt	eleanor roosevelt
what are the religions practiced in indonesia	indonesia	indonesia
what was jesse james killed with	jesse james	jesse james
who was vp for lincoln	lincoln	for lincoln
what other books did charles dickens write	charles dickens	charles dickens
who was the first dictator of the soviet union	soviet union	soviet union
what is the currency of puerto rico called	puerto rico	puerto rico
what kind of cancer did carl wilson have	carl wilson	carl wilson
who plays the voice of kitt in knight rider	knight rider	knight rider
what county is brentwood tennessee in	brentwood	brentwood
who did michael j fox marry	michael j fox	michael j fox
what battles did stonewall jackson fight in	stonewall jackson	stonewall jackson
what language do the maasai tribe speak	maasai	maasai tribe speak
who did benjamin franklin get married to	benjamin franklin	benjamin franklin
what disease did patrick swayze died from	patrick swayze	patrick swayze
what works of art did leonardo da vinci produce	leonardo da vinci	leonardo da vinci
what capital of austria	austria	austria
what type of cancer did eva peron have	eva peron	eva peron
what country did buddha come from	buddha	buddha
what county is greeley colorado in	greeley	greeley
what did peter tchaikovsky do	peter tchaikovsky	peter tchaikovsky
which countries speak german officially	german	german
what type of music did john lennon sing	john lennon	john lennon
who are the colorado representatives	colorado representatives	colorado
which country does greenland belong to	greenland	greenland
what the zip code for seattle washington	seattle washington	seattle
who is willow smith mom name	willow smith	willow smith
what do you call the chinese writing system	chinese	chinese writing
who played on the jeffersons	jeffersons	the jeffersons
what is the name of the san francisco newspaper	san francisco	san francisco
what continent does armenia belong to	armenia	armenia
what did randy savage died of	randy savage	randy savage
what was the title of the book charles darwin wrote	charles darwin	charles darwin
where did richard nixon die	richard nixon	richard nixon
what songs does smokey robinson sing	smokey robinson	smokey robinson
who was vice president when jfk was president	when jfk was	when jfk
what is serbian language called	serbian	serbian
what language is spoken in haiti today	haiti	haiti
who played barbara gordon batgirl	barbara gordon batgirl	barbara gordon
what basketball teams has shaq played for	shaq played	shaq played for
where is jay leno from	jay leno	jay leno
what language do people from thailand speak	thailand	thailand
who did armie hammer play in the social network	the social network	the social network
what was thomas jefferson role in the declaration of independence	thomas jefferson	thomas jefferson
what was the book written by charles darwin	charles darwin	charles darwin
who did tim tebow play college football for	tim tebow	tim tebow
who does peyton manning play football for	peyton manning	peyton manning
where is the carpathian mountain range located	carpathian mountain	carpathian mountain
what was robert burns	robert burns	robert burns
who did the voice of darth vader in episode 3	darth vader in episode 3	darth vader
what super bowl did peyton manning win	peyton manning	peyton manning
which country was justin bieber born in	justin bieber	justin bieber
who fought in the gulf war 1991	gulf war	gulf war
who plays london tipton in suite life on deck	suite life on	suite life on deck
what team did david beckham play for in 2011	david beckham	david beckham
where did francisco coronado come from	francisco coronado	francisco coronado
what all does google now do	google	google
what language does egyptian people speak	egyptian	egyptian
what are abraham sons names	abraham sons	abraham
who wrote the jana gana mana	jana gana	jana gana mana
what type of cancer did gilda radner die of	gilda radner	gilda radner
who plays juni cortez	juni cortez	juni cortez
what was lucille ball	lucille	lucille ball
who inspired obama	inspired obama	obama
who is michael j fox wife	michael j fox	michael j fox
where did dolly parton grow up	dolly parton	dolly parton
what type of books did agatha christie wrote	agatha christie	agatha christie
what are the four main languages spoken in spain	spain	spain
where is the nra headquarters located	is the nra	the nra headquarters located
who is gimli 's father in the hobbit	gimli	gimli
who developed the tcp ip reference model	reference model	the tcp ip reference model
what college did albert einstein go to	albert einstein	albert einstein
what team does jordan own	jordan	jordan
who is the state governor of tennessee	tennessee	tennessee
what do portuguese people speak	portuguese people	portuguese
what language does cuba speak	cuba	cuba
what are the sights to see in madrid	madrid	madrid
what instruments did louis armstrong play	louis armstrong	louis armstrong
what time zone am i in california	california	california
where is mission san buenaventura located	san buenaventura	mission san buenaventura
what time in hilo hawaii	hilo	hilo
where did rudolf virchow conduct his research	rudolf virchow	rudolf virchow
what university did gordon brown attend	gordon brown	gordon brown
what countries does greece share borders with	greece	greece
what year did the seahawks win the superbowl	the seahawks	the seahawks
what did stephen hawking become famous for	stephen hawking	stephen hawking
who plays donna noble	donna noble	donna noble
what was dr seuss education	dr seuss	dr seuss
where did queensland get its name from	queensland	queensland
what document did james madison write	james madison	james madison
what are the three official languages of belgium	belgium	belgium
who played bilbo in lord of the rings	bilbo	played bilbo
what airport do you fly into to get to destin fl	destin	destin
what do you call members of the senate	NOT FOUND	of the senate
what countries are part of the baltic	baltic	baltic
what team does colin kaepernick play for	colin kaepernick	colin kaepernick
where did joe flacco attend college	joe flacco	joe flacco
who is emma stone father	emma	emma stone
where was theodore roosevelt buried	theodore roosevelt	theodore roosevelt
who was the leader of the us during wwii	wwii	who was
what artistic movement did henri matisse belong to	henri matisse	henri matisse
where the missouri river ends	missouri river	missouri river
what type of currency do they use in thailand	thailand	thailand
who is khloe kardashian 's husband	khloe kardashian	khloe kardashian
what state does romney live in	does romney	romney
what type of government does france use	france	france
who rules denmark right now	denmark	denmark
what did stephen hawking study	stephen hawking	stephen hawking
where did bristol palin go to school	bristol palin	bristol palin
what region of the world is egypt associated with	egypt	egypt
what did dr . seuss do	dr . seuss	dr . seuss
where did drew brees go to college wikianswers	drew brees	drew brees
what school did ben roethlisberger go to	ben roethlisberger	ben roethlisberger
where did the iroquois indians come from	iroquois	iroquois
what kind of guitar did george harrison use	george harrison	george harrison
what language do navajo people speak	navajo	navajo people
what places make up new england	new england	new england
what type of government does iraq have now	iraq	iraq
where was the vietnam war location	vietnam war	vietnam war
who did gerald ford select as his vice president when he became president	gerald ford	gerald ford
what is the currency used in italy	italy	italy
what is the capital of modern egypt	egypt	egypt
what school did sir ernest rutherford go to	sir ernest rutherford	ernest rutherford
what position does brandon roy play	brandon roy	brandon roy
where is harvard university	harvard university	harvard university
where is laos in world map	laos	laos
where is tyrese gibson from	tyrese gibson	tyrese gibson
what countries are near italy	italy	italy
which states does the colorado river run through	colorado river	colorado river
who did scarlett johansson date	scarlett johansson	scarlett johansson
which continents were part of the roman empire	roman empire	roman empire
where was elvis costello born	elvis costello	elvis costello
where are the gobi desert located on a map	gobi desert located on	gobi desert
what type of government does the us follow	what type of government	what type of government
in which continent is germany	germany	germany
what language turkey people speak	turkey	turkey
who does jeremy lin play for	jeremy lin	jeremy lin
where is the seychelles on world map	seychelles	seychelles
where did william morris go to college	william morris	william morris
what state is mount st . helens in	mount st . helens	mount st . helens
who is jimmy savile	jimmy savile	jimmy savile
where were the seneca indians located	seneca	seneca
when did florida marlins join mlb	florida marlins	florida marlins
what countries have spanish as the national language	spanish as	spanish as
what to see in phoenix arizona	phoenix	phoenix
what countries does the panama canal go through	panama canal	panama canal
what is charlie chaplin famous for	charlie chaplin	charlie chaplin
what did fred durst do	fred durst	fred durst
where do american bulldogs originate from	american bulldogs	american bulldogs
what colleges did albert einstein teach at	albert einstein	albert einstein
who plays the voice of brian on family guy	family guy	family guy
where did george w bush live as a child	george w bush	george w bush
what was nikola tesla inventions	nikola tesla	nikola tesla
where did flemish people come from	flemish people	flemish people
what state new york city belong to	new york city	new york city
what was the cause of death for bruce lee	bruce lee	bruce lee
what type of government does usa follow	what type of government does	what type of government
what type of currency do they use in england	england	england
where was benjamin franklin educated	benjamin franklin	benjamin franklin
what countries included in the uk	what countries included in	countries included
what countries in the world speak chinese	chinese	chinese
where obama went to school	obama	where obama
what is the primary language of china	china	china
who was the soviet leader during world war ii	during world war ii	soviet
which of the following does australia export the most	australia	australia
where was the city of david	david	city of david
what is cindy sherman known for	cindy sherman	cindy sherman
what tv shows did shawnee smith play in	shawnee smith	shawnee smith
what does australia use for currency	australia	australia
which airport to fly into rome	rome	rome
what is there to do for fun in kansas city	kansas city	kansas city
where was martin luther king jr raised	martin luther king jr	martin luther king jr
what year was lebron james rookie season	lebron james	lebron james
where does delaware river start	delaware river	delaware river
what kind of monarchy does japan have	japan	japan
where did mitt romney 's parents come from	mitt romney	mitt romney
where was mission san rafael located	mission san rafael	mission san rafael
who was esther 's husband	esther	esther
who 's dating claire danes	claire danes	claire danes
what county is st paul va in	paul va	st paul
what type of sports do japanese play	japanese	japanese
which countries share a border with russia	russia	russia
where did the latin language originate from	latin language	latin language
what school did karl benz go to	karl benz	karl benz
what movies has carmen electra been in	carmen electra	carmen electra
where did morgan freeman graduate	morgan freeman	morgan freeman
who was carolus linnaeus	carolus	carolus linnaeus
what type of government does germany have now	germany	germany
what kind of government does libya have today	libya	libya
what time zone is anaheim california	anaheim	anaheim
what year did the orioles go to the world series	the orioles	the orioles
who is sir francis bacon	francis bacon	francis bacon
what were amelia earhart 's achievements	amelia earhart	amelia earhart
what are the official colors of the dallas cowboys	dallas cowboys	dallas cowboys
where did margaret hoover go to college	margaret hoover	margaret hoover
what is jamie oliver children names	jamie oliver	jamie oliver
where does bradley walsh live	bradley walsh	bradley walsh
who is the head coach of inter milan	inter milan	inter milan
who did reese witherspoon get married to	reese witherspoon	reese witherspoon
what kind of money should i take to costa rica	costa rica	costa rica
where is the ufc headquarters	ufc	is the ufc headquarters
who plays captain kirk in star trek	captain kirk	plays captain kirk
who does albert pujols play for 2012	albert pujols	albert pujols
what kind of government is sweden	sweden	sweden
where was country singer george jones born	george jones	george jones
what did shakespeare become famous for	did shakespeare	did shakespeare
where does russia import from	russia	where
what is the money of switzerland called	switzerland	switzerland
what do people in australia speak	australia	australia
what has ian somerhalder acted in	ian somerhalder	ian somerhalder
what movies did ron howard director	ron howard	ron howard
what did gerald r ford die from	gerald r ford	gerald r ford
what two continents is turkey on	turkey	turkey
where did kevin love go to college	kevin love	kevin love
what type of government was formed when italy unified	italy unified	italy
where was the temple of karnak built	temple of karnak	karnak
what movies did morgan freeman star in	morgan freeman	morgan freeman
who did john kennedy have affairs with	john kennedy	john kennedy
what type of money to take to cuba	cuba	cuba
what currency should you take to morocco	morocco	morocco
who is mary mcleod bethune for kids	mary mcleod bethune	mary mcleod bethune
what do they call money in japan	japan	japan
what nationality is mother teresa	mother teresa	mother teresa
who is richard pryor son	richard pryor	richard pryor
what countries share borders with spain	spain	spain
what countries have english as their official language	english as	english as
what international organizations is china part of	china	china
what county is west st paul in	west	west st paul
who does donnie wahlberg play in the sixth sense	the sixth sense	the sixth sense
what did baron de montesquie influence	baron de montesquie	montesquie
who did carlos boozer play for	carlos boozer	carlos boozer
who owns the portland press herald	portland press herald	portland press herald
what did albert speer design	albert speer	albert speer
what art movement did leonardo da vinci belong to	leonardo da vinci	leonardo da vinci
what airport is near arlington tx	arlington	arlington
what team does heskey play for	heskey	team does heskey
where did emperor hirohito live	hirohito	hirohito
what to do and see in vienna austria	vienna	vienna
when did conflict start in ireland	ireland	ireland
what is there to do in peoria illinois	peoria	peoria
what language do british speak	british	language do
what makes elvis presley famous	elvis presley	elvis presley
what language do people speak in the netherlands	netherlands	netherlands
what are the major languages spoken in greece	greece	greece
what type of artist is henri matisse	henri matisse	henri matisse
what was the first book charles dickens wrote	charles dickens	charles dickens
what books did agatha christie wrote	agatha christie	agatha christie
what school did michael jordan attend	michael jordan	michael jordan
where is mount st helens volcano	mount st helens	mount st helens
what shows are shot in new york	new york	new york
what book did tupac write	tupac write	tupac write
what language do chinese people write in	chinese	what language
what was robert burns famous for	robert burns	robert burns
what are the important holidays of islam	islam	islam
what type of music did claude debussy play	claude debussy	claude debussy
when was the last time the toronto maple leafs were in the stanley cup finals	toronto maple leafs	stanley cup finals
what team is hank baskett on 2010	hank baskett	hank baskett
what are the two official languages of paraguay	paraguay	paraguay
what state is the steelers from	the steelers	the steelers
what college did sir isaac newton go to	isaac newton	isaac newton
what are the school colors for harvard university	harvard university	harvard university
where is the university of the rockies located	university of the rockies	university of the rockies
what disease does robin roberts have	robin roberts	robin roberts
what was the capital city of the east roman empire	east roman empire	roman empire
who plays edward scissorhands	edward	edward scissorhands
what does joey jordison play in slipknot	slipknot	slipknot
what kind of language does turkey speak	turkey	turkey
what was lebron james first team	lebron james	lebron james
who fought the battle of gettysburg	battle of gettysburg	battle of gettysburg
who is the coach of the sf giants	sf giants	sf giants
who was the first president of the afl	president	president of the afl
where did giuliana rancic grow up	giuliana rancic	giuliana rancic
what are the major cities in ukraine	ukraine	ukraine
who does brian dawkins play for 2011	brian dawkins	brian dawkins
what movies did tupac star in	tupac star	tupac star
what form of currency does china have	china	china
who plays kenneth	kenneth	kenneth
what league are the indianapolis colts in	indianapolis colts	indianapolis colts
what country did magellan represent	magellan	did magellan
where is perpignan located	perpignan	perpignan
who did kim richards marry	kim richards	kim richards
what happened in bosnia in the 90s	bosnia	bosnia in the
when 's the last time the steelers won the superbowl	the steelers	the steelers
where english is spoken	english is	english is
where is giza pyramids located	giza pyramids	giza pyramids
what is the zip code for midland tx	midland	midland
what states make up the midwest us	midwest us	midwest us
what instruments does justin bieber use	justin bieber	justin bieber
what language does australians speak	australians	australians
who did annie oakley married	annie oakley	annie oakley
who has played lex luthor	lex luthor	lex luthor
where does the zambezi river start	zambezi	zambezi
what is the nigeria time	nigeria	nigeria
where did they find jenni rivera 's body	jenni rivera	jenni rivera
what university did romney graduated from	romney	did romney
where is the time zone line in south dakota	south dakota	south dakota
where is jason mraz from	jason mraz	jason mraz
what killed john bonham	john bonham	john bonham
what industry does walmart operate in	walmart	walmart
what county is texarkana arkansas in	texarkana	texarkana arkansas
what music period did beethoven live in	did beethoven	did beethoven
what did laura ingalls wilder wrote	laura ingalls wilder	laura ingalls wilder
what type of government system does italy have	italy	italy
what did john irving wrote	john irving	john irving
what is the national flower of hawaii	hawaii	hawaii
what did alice paul accomplish	alice paul	alice paul
what languages do they speak in costa rica	costa rica	costa rica
where did hank marvin come from	hank marvin	hank marvin
when did chipper jones get drafted	chipper jones	chipper jones
what part did winona ryder play in star trek	winona ryder	star trek
where did jovan belcher kill himself	jovan belcher	jovan belcher
where did clay matthews go to school	clay matthews	clay matthews
what time is it in texas houston right now	texas houston	houston
who is princess leia in star wars	leia in	leia in
what is the political structure of china	china	china
what is new york city airport	new york city airport	new york city
what language brazil speak	brazil	brazil
who played obi wan in episode 2	obi wan in	obi wan in
where did venus williams come from	venus williams	venus williams
what currency is used in panama	panama	panama
where does the zambezi river originate	zambezi	zambezi
what team did ronaldo play for in 2003	ronaldo	ronaldo
where does robin williams live 2011	robin williams	robin williams
who played jacob black in twilight	twilight	jacob black
which airport to fly into in buenos aires	buenos aires	buenos aires
what team did adrian peterson play for in college	adrian peterson	adrian peterson
where does name pennsylvania come from	pennsylvania	pennsylvania
what kind of money do they use in germany	germany	germany
who plays blaine in batman	batman	batman
what language does australia use	australia	australia
who did veronica lake mary	veronica lake	veronica lake
who did sir francis drake marry	francis drake	francis drake
who plays stephanie plum in one for the money	stephanie plum	one for the money
what did the ancient romans speak	romans speak	romans speak
what does ringo sing	ringo	ringo sing
where was st . lucy born	st . lucy born	st . lucy
what type of government does australia have	australia	australia
who was the father of king george vi	george vi	george vi
what is the zip code for trenton	trenton	trenton
what has ashley greene been in	ashley greene	ashley greene
where did al qaeda attack	al qaeda	al qaeda
what language is spoken in switzerland	switzerland	switzerland
who was philip in acts chapter 8	acts chapter 8	philip in acts chapter
what the time zone in england	england	england
what is the best currency to take to turkey	turkey	turkey
what system of government is practiced in nigeria	nigeria	nigeria
who were mary shelley	mary shelley	mary shelley
what language do most australians speak	australians	australians
where is denmark situated	denmark	denmark
where was teddy roosevelt 's house	teddy roosevelt	teddy roosevelt
what is the government system of malaysia	malaysia	malaysia
what do people speak in canada	canada	canada
what type of money do they use in costa rica	costa rica	costa rica
what timezone is nashville tn	nashville	nashville
where did adolf hitler die	adolf hitler	adolf hitler
what is the largest nation in europe	europe	europe
where was the first gulf war fought	gulf war	gulf war
who are the senators of virginia 2013	virginia	virginia
what band was george clinton in	george clinton	george clinton
what country borders slovakia	slovakia	slovakia
what was james garfield most known for	james garfield	james garfield
where did paula deen go to school	paula deen	paula deen
where does robert irvine come from	robert irvine	robert irvine
what style of music does michael jackson perform	michael jackson	michael jackson
what does david beckham play	david beckham	david beckham
what does julian lennon do	julian lennon	julian lennon
what is the milwaukee brewers mascot	milwaukee brewers	milwaukee brewers
what is the second biggest state in the united states	united states	united states
what has charlie hunnam been in	charlie hunnam	charlie hunnam
what are all the movies taylor swift has been in	taylor swift	taylor swift
what college did brett favre	brett favre	brett favre
where did alex chilton die	alex chilton	alex chilton
what college did martin luther king jr go to	martin luther king jr	martin luther king jr
what kind of cancer did farrah fawcett die of	farrah fawcett	farrah fawcett
who is michael j fox 's wife	michael j fox	michael j fox
what money do i use in costa rica	costa rica	costa rica
what guitar did joe walsh play	joe walsh	joe walsh
what are the official languages of the eu	languages	of the eu
what is ryan seacrest radio show	ryan seacrest	ryan seacrest
what language do most italians speak	italians	italians
what money do they use in spain	spain	spain
what did drew barrymore go to rehab for	drew barrymore	drew barrymore
when is saint george day celebrated	saint george	saint george day
what government did the roman empire have	roman empire	roman empire
what instrument did robin gibb play	robin gibb	robin gibb
who voiced darth vader	darth vader	darth vader
when was abe lincoln president	abe lincoln	abe lincoln
where are the texas rangers playing	texas rangers	texas rangers
what is arkansas state capitol	arkansas	arkansas state capitol
what is the zip code for nogales az	nogales	nogales
what is william taft famous for	william taft	william taft
where did robin cook die	robin cook	robin cook
where did melba beals live	melba beals	melba beals
who is louisiana state senator	louisiana	louisiana
what are the 7 countries that are part of central america	central america	central america
where did derek fisher go to college	derek fisher	derek fisher
who was kobe bryant drafted by	kobe bryant	kobe bryant
where are the new orleans hornets moving to	new orleans hornets	orleans hornets
what language does algerian people speak	algerian	algerian
where was anne boleyn executed	anne boleyn	anne boleyn
what did galileo do to become famous	galileo do	galileo
what school did martin luther king jr received his doctorate degree from	martin luther king jr	martin luther king jr
where buddha come from	buddha	buddha
what did king henry viii rule	henry viii	henry viii rule
what type of cancer did larry hagman have	larry hagman	larry hagman
what wars did robert e lee served in	robert e lee	robert e lee
what russian language called	russian	russian
who is in charge of libya now	libya	libya
what kind of disease does montel williams have	montel williams	montel williams
when is the last time the ravens won a superbowl	ravens	time the ravens
where did kansas city royals come from	kansas city royals	kansas city royals
what style of music does john mayer play	john mayer	john mayer
what inventions did thomas edison invent list	thomas edison	thomas edison
where did djokovic come from	djokovic	djokovic
what part of the country is new england	new england	new england
what money to take to turkey	turkey	turkey
what kind of music did jimi hendrix play	jimi hendrix	jimi hendrix
what degrees did obama get in college	obama	obama
who were alexander graham bell 's siblings	alexander graham bell	alexander graham bell
when did liverpool fc last win the champions league	liverpool fc	liverpool fc
who played jeannie	jeannie	jeannie
where was st peter killed	peter killed	st peter
who does jeremy shockey play for in 2012	jeremy shockey	jeremy shockey
what college did deion sanders jr go to	deion sanders jr	deion sanders
what were the names of henry viii 's three children	henry viii	henry viii
where did tim tebow grow up	tim tebow	tim tebow
where is chesapeake bay bridge	chesapeake bay	chesapeake bay bridge
who played victoria barkley	victoria barkley	barkley
where did kennedy 's inaugural address take place	kennedy	kennedy
what countries have german as the official language	german as	language
where did the taliban began	taliban	taliban
who plays elena gilbert on vampire diaries	vampire diaries	elena gilbert
what does the missouri river bisect	missouri river	missouri river
what nationality is taylor lautner jacob black	taylor lautner	taylor lautner
what animal represents california	california	california
what company does nike own	does nike own	nike own
what language do colombian people speak	colombian	colombian
what is claire danes famous for	claire danes	claire danes
what county is san antonio in	san antonio	san antonio
what characters does matt stone do	matt stone	matt stone
what timezone is the state of michigan and	michigan	michigan
what type of government did soviet union have	soviet union	soviet union
what languages are there in japan	japan	japan
who was saint paul the apostle	paul the apostle	paul the apostle
where did vince scully go to college	vince scully	vince scully
where does princess leia live	leia live	leia
what famous people are from el salvador	el salvador	el salvador
what type of art did leonardo da vinci make	leonardo da vinci	leonardo da vinci
where did mary bell live	mary bell	mary bell
who did kimberly williams marry	kimberly williams	kimberly williams
what other movies has ryan gosling been in	ryan gosling	ryan gosling
what political party does julia gillard belong to	julia gillard	julia gillard
what is the currency of germany now	germany	germany
what kind of hispanic is selena gomez	selena gomez	selena gomez
who did denise van outen married	denise van outen	denise van outen
what are egyptian money called	egyptian	egyptian
what is the zip code for wyoming michigan	wyoming	wyoming
who is the president of costa rica in 2012	costa rica	costa rica
where did martin luther king got shot at	martin luther king	martin luther king
who wrote the gospel according to john	john	gospel according to john
what form of government is the uk	is	is the uk
who did nasri play for before arsenal	arsenal	did nasri
what currency does the czech republic use now	czech republic	czech republic
what was firefox programmed in	firefox programmed	firefox
what government does new zealand have	new zealand	new zealand
where is isthmus of panama located on the map	isthmus of panama	isthmus of panama
what is the capital of republic of ireland	republic	republic of ireland
what has kristen stewart acted in	kristen stewart	kristen stewart
what did dr josef mengele do	josef mengele	josef mengele
what kind of language does egypt speak	egypt	egypt
who are the senators of hawaii 2012	hawaii	hawaii
what form of government does north korea have	north korea	north korea
where did robert kardashian go to college	robert kardashian	robert kardashian
what county is st james city fl in	st james city	st james city
what did the akkadian empire include	akkadian	akkadian empire
after how many years are the olympic games held	olympic games	olympic games
what system of government does guyana have	guyana	guyana
what team did aguero play for	aguero	did aguero
who is the president of the european union 2012	european union	european union
what year was kenya moore crowned miss usa	kenya moore	miss usa
what sort of government does nigeria have	nigeria	nigeria
where does chef ina garten live	chef ina garten	ina garten
when the atlanta braves won the world series	atlanta braves	atlanta braves
what kind of language do they speak in iran	iran	iran
what was the first language spoken in spain	spain	spain
what did scott joplin play	scott joplin	scott joplin
what school did miley cyrus	miley cyrus	miley cyrus
what language do most people speak in afghanistan	afghanistan	afghanistan
what role did paul mccartney play in the beatles	paul mccartney	paul mccartney
when did juventus win the champions league	juventus	juventus
who is robin roberts father	robin roberts	robin roberts
what is the capital of australia victoria state	australia victoria	victoria
where is french spoken most	french	french
what team is reggie bush on 2011	reggie bush	reggie bush
what highschool did emily osment go to	emily osment	emily osment
what currency should i take to mexico	mexico	mexico
who is thor heyerdahl	thor heyerdahl	thor heyerdahl
where did troy aikman play football	troy aikman	troy aikman
who played cletus hogg	cletus	cletus hogg
who won fa cup 1976	fa cup	fa cup
what did general robert e lee die from	robert e lee	robert e lee
what style of art did henri matisse do	henri matisse	henri matisse
who plays chuck bass in gossip girl	gossip girl	gossip girl
what countries have territories in oceania	oceania	oceania
what county is st . louis park in	st	st . louis park
what is the political system of south africa	south africa	south africa
what language group does germany belong to	germany	what language
what timezone is tucson arizona in right now	tucson	tucson
which political party does barack obama represent	barack obama	barack obama
what kind of leukemia did jill clayburgh have	jill clayburgh	jill clayburgh
what is there to see in sydney australia	sydney	sydney
where was marilyn monroe found dead	marilyn monroe	marilyn monroe
what states does the sierra nevada run through	sierra nevada	sierra nevada
what language is spoken in greek	greek	greek
what is the name of the speaker of the house of representatives now 2011	speaker of the house of representatives	speaker of the house of representatives
who plays stanley hudson	stanley hudson	stanley hudson
what record label is kelly clarkson signed with	kelly clarkson	kelly clarkson
where does tim roth come from	tim roth	tim roth
what currency should you take to vietnam	vietnam	vietnam
who did roger federer married	roger federer	roger federer
what kind of money do i need in costa rica	costa rica	costa rica
what is the name of the capital of belgium	belgium	belgium
what kind of government does japan have now	japan	japan
what pieces of music did claude debussy compose	claude debussy	claude debussy
who was selena gomez in barney and friends	selena gomez	barney and friends
who plays caesar flickerman in the hunger games	the hunger	the hunger games
where did the gettysburg address	the gettysburg	gettysburg address
what was the name of jfk 's brothers	jfk 's	the name of jfk
who was tupac signed to	tupac signed	tupac
what was augustus caesar famous for	augustus	augustus
what language does colombia	colombia	colombia
what is the zip code for schenectady new york	schenectady	schenectady
who was president in 1988 in the united states	united states	president in 1988 in the united states
who owns google 2012	google	google
what drink did john pemberton create	john pemberton	john pemberton
what position did stanley matthews play	stanley matthews	did stanley matthews
what was bonnie prince charlie full name	bonnie prince charlie	charlie full
who makes the voice of stewie griffin	stewie griffin	stewie griffin
who is angelina jolie mom and dad	angelina jolie	angelina jolie
who is the governor of indiana 2009	governor of indiana	governor of indiana
who brad pitt has dated	brad pitt	brad pitt
what party does barack obama belong to	barack obama	barack obama
what is san francisco zip code	san francisco	san francisco
who has stephen ireland played for	stephen ireland	stephen ireland
where did john mayer go to college	john mayer	john mayer
what celebrities has brody jenner dated	brody jenner	brody jenner
what is malaysian currency	malaysian	malaysian
who owns volkswagen car company	volkswagen car	volkswagen car
which is the main train station in rome	rome	rome
what did steve mcnair died from	steve mcnair	steve mcnair
who is the newly elected governor of california	california	california
who plays roxanne in ghost rider	ghost rider	ghost rider
where is the sony ericsson company	sony ericsson	sony ericsson
what kind of currency does the dominican republic have	dominican republic	dominican republic
what to do this weekend in manchester with kids	manchester	manchester
what sport is popular in italy	italy	italy
where is the main headquarters of google	google	google
what was jesse owens education	jesse owens	jesse owens
where does carlos santana live	carlos santana	carlos santana
what is the new movie john carter about	john carter	john carter
what countries does nafta include	countries	countries does nafta
what county is houston tx in	houston	houston
where do the seattle seahawks play	seattle seahawks	seattle seahawks
who does michael keaton play in cars	cars	cars
where is the riviera casino	riviera	riviera
what is the holy book of the buddhist religion	buddhist	buddhist
who became president when henry harrison died	henry harrison	henry harrison
where did richard arkwright grow up	richard arkwright	richard arkwright
what other books did louis sachar write	louis sachar	louis sachar
when did roth ira originate	roth	roth ira
who does the voice for darth vader	darth vader	darth vader
what did thomas malthus do	thomas malthus	thomas malthus
what is the zip code for newark california	newark	newark
what states share a border with tennessee	tennessee	tennessee
what war did the us lose the most soldiers	what war	did the us lose the
what kind of government is egypt	egypt	egypt
what musical instruments does justin bieber play	justin bieber	justin bieber
where do john lennon die	john lennon	john lennon
what is the current time in bangalore india	bangalore	bangalore
what language do people from greece speak	greece	greece
where is the phillies spring training stadium	phillies spring	the phillies
what movies does matt dallas play in	matt dallas	matt dallas
who was john f kennedy 's family	john f kennedy	john f kennedy
where is harley davidson corporate headquarters	harley davidson	harley davidson corporate
where was the ottoman empire based	ottoman empire	ottoman empire
where was bin laden found and killed	was bin laden	was bin laden
what are the names of harry potter movies in order	harry potter	harry potter
what did pamela courson die from	pamela courson	pamela courson
what did dr jack kevorkian do	jack kevorkian	jack kevorkian
what does bolivia border	bolivia	bolivia
who does nolan ryan play for	nolan ryan	nolan ryan
what country does justin bieber come from	justin bieber	justin bieber
what is the head judge of the supreme court called	supreme court called	supreme court called
who was frida kahlo influenced by	frida kahlo	frida kahlo
where is taylor swift from	taylor swift	taylor swift
what type of religion does argentina have	argentina	argentina
when is the last time the giants won the world series	time the giants	last time the giants
what is the main language used in china	china	china
where did the battle of waterloo occur	battle of waterloo	battle of waterloo
who did vladimir lenin marry	vladimir lenin	vladimir lenin
what year did the baltimore ravens win superbowl	baltimore ravens	baltimore ravens
what team does cristiano ronaldo play for 2011	cristiano ronaldo	cristiano ronaldo
what is money called in italy	italy	italy
where did theodor schwann study	theodor schwann	theodor schwann
who are the virginia senators 2013	virginia	virginia
what countries are members of the security council	countries are	the security council
where are the nordic countries	nordic countries	nordic countries
what country sponsored ferdinand magellan	ferdinand magellan	ferdinand magellan
what did vera ellen die from	vera ellen	vera ellen
what is the capital of modern day egypt	egypt	egypt
what province is toronto in ( 7 letters )	toronto	toronto
what is the currency of brazil now	brazil	brazil
what types of art did andy warhol do	andy warhol	andy warhol
what other states border florida	florida	florida
what are the predominant religions in russia	russia	russia
who will coach carolina panthers in 2013	carolina panthers	carolina panthers
where did louis sachar grow up	louis sachar	louis sachar
what to do for fun in houston	houston	houston
where did otto frank go to college	otto frank	otto frank
what else has jennifer lawrence played in	jennifer lawrence	jennifer lawrence
who is the governor of pennsylvania state now	pennsylvania	pennsylvania
where is ancient phoenician	phoenician	phoenician
where does the celtics practice	the celtics	does the celtics
where bin laden got killed	where bin laden	bin laden
where does toronto get its water from	toronto	toronto
what language do people from bosnia speak	bosnia	bosnia speak
where did hugo chavez go to school	hugo chavez	hugo chavez
who does japan import from	japan	japan
what is the name of sonia gandhi daughter	sonia gandhi	sonia gandhi
who do islamic people pray to	islamic	islamic
where was mary todd lincoln from	mary todd lincoln	mary todd lincoln
where did charles darwin die	charles darwin	charles darwin
what movies does nick cannon play in	nick cannon	nick cannon
who was king george vi married to	george vi	george vi
where was jesus after he died on the cross	jesus after	jesus after
who is sir james dyson	james dyson	james dyson
who voiced darth vader in the original star wars movies	darth vader	darth vader
what high school did maya angelou go to	maya angelou	maya angelou
what 5 countries border switzerland	switzerland	switzerland
what country did benito mussolini govern	benito mussolini	benito mussolini
who was the leader of the first communist party of china	communist party of china	communist party of china
what did miles davis died of	miles davis	miles davis
what is the zip code for azle texas	azle	azle
what date did sally pearson won gold	sally pearson	sally pearson
when did the detroit pistons last win the championship	detroit pistons	detroit pistons
when did the philadelphia flyers win the cup	philadelphia flyers	philadelphia flyers
what county is st paul nc in	paul nc	st paul
where is olympic national park wa	olympic national park	olympic national park
where did nat turner 1831 rebellion occur	nat turner 1831 rebellion	nat turner 1831 rebellion
who would play luke skywalker	luke skywalker	luke skywalker
where turkish people originate	turkish	turkish people
what state is barack obama from	barack obama	barack obama
what awards gary paulsen won	gary paulsen	gary paulsen
where did alexander graham bell die	alexander graham bell	alexander graham bell
what year did the golden state warriors win their first nba championship	golden state warriors	golden state warriors
what currency should i take to turkey	turkey	turkey
what countries are in the uk yahoo	in	countries are in
what superbowl did the baltimore ravens win	baltimore ravens	baltimore ravens
what is the language of russia s spoken	russia	russia
who is the king of cambodia now	cambodia	cambodia
who are serena williams parents	serena williams	serena williams
what schools did sir isaac newton go to	isaac newton	isaac newton
what was the cause of death for huell howser	huell howser	huell howser
what books are written by suzanne collins	suzanne collins	suzanne collins
what countries does england border	england	england
what team did messi play for in 2010	messi	did messi
what time zone is greensburg indiana	greensburg	greensburg
who plays voldemort	plays voldemort	voldemort
what colleges did harper lee attend	harper lee	harper lee
who founded the kkk	kkk	kkk
what jobs did john adams have before he was president	john adams	john adams
what political party did andrew johnson belong to	andrew johnson	andrew johnson
where was osama bin laden killed	osama bin laden	osama bin laden
where were greek temples built	greek temples	were greek temples
where are people who speak arabic from	arabic	arabic
who was queen elizabeth ii mom	elizabeth ii	elizabeth ii
what type of art did pablo picasso paint	pablo picasso	pablo picasso
what is ella fitzgerald parents name	ella fitzgerald	ella fitzgerald
who is anne hathaway parents	anne hathaway	anne hathaway
who does don draper gets engaged to	don draper	don draper
what was van halen first album	van halen	van halen
what political system did spain have	spain	spain
what are the supreme court cases	supreme court cases	supreme court cases
what is penn state 's main campus	penn state 's	penn state 's
what country does alaska belong to	alaska	alaska
where is kansas city	kansas city	kansas city
what was pink floyd 's first album	pink floyd	pink floyd
who did granville t. woods married	granville t. woods	granville t. woods
what language did the sioux indians speak	sioux	sioux
what are some famous people from el salvador	el salvador	el salvador
who did brett gardner play for in 2008	brett gardner	brett gardner
who plays dwight in the office	the office	the office
what county is san diego ca	san diego	san diego
who is the miami dolphins quarterback	miami dolphins	miami dolphins
where did anne frank go to school	anne frank	anne frank
what basketball player is married to monica	monica	monica
what did hitler use to kill himself	did hitler	did hitler
what do people speak in germany	germany	germany
when is the last time the denver broncos won the superbowl	denver broncos	denver broncos
where was caesar when he was stabbed	when	was caesar
what style of music did bessie smith perform	bessie smith	bessie smith
what team did jackie robinson	jackie robinson	jackie robinson
what time zone is chicago in right now	chicago	chicago
who was the vice president under ronald reagan	ronald reagan	ronald reagan
where do the chicago white sox play home games	chicago white sox	chicago white sox
what part did jeff conaway play in grease	grease	grease
what book did benjamin franklin published	benjamin franklin	benjamin franklin
what currency to take to barbados	barbados	barbados
where did they get the name stanley cup	name stanley cup	stanley cup
what is the zip code of syracuse ny	syracuse	syracuse
where did tennessee williams go to college	tennessee williams	tennessee williams
what is the name of airport in new york	new york	new york
who was queen victoria 's husband	queen victoria	queen victoria
where did benjamin franklin work	benjamin franklin	benjamin franklin
what does barbara bush do for work	barbara bush	barbara bush
who is jacob latimore	jacob latimore	jacob latimore
what happened to dunkirk during ww2	ww2	dunkirk
what was scottie pippen good at	scottie pippen	scottie pippen
who played donna on west wing	donna	donna on
who played meg in season 1 of family guy	meg in	meg in
when was the last time the dallas cowboys won the superbowl	dallas cowboys	dallas cowboys
where do ireland play rugby union	ireland	ireland play rugby union
who killed lee harvey oswald shot	lee harvey oswald	lee harvey oswald
when was the last time knicks won the championship	time knicks	time knicks
when did celtics win the championship	celtics	celtics
what countries included in oceania	oceania	oceania
what country is nicki minaj from	nicki minaj	nicki minaj
who played harry potter dumbledore actor	harry potter	potter dumbledore
who was the prime minister of pakistan in 1999	pakistan	prime minister of pakistan
what movies did christopher plummer play in	christopher plummer	christopher plummer
what is capital city of morocco	morocco	morocco
what movies is omar epps in	omar epps	omar epps
what district does nancy pelosi represent	nancy pelosi	nancy pelosi
where is walton indiana	walton	walton
where did george herbert walker bush go to college	george herbert walker bush	george herbert walker bush
what did bruce jenner win gold medal for	bruce jenner	bruce jenner
where do they speak tibetan	tibetan	speak tibetan
what to do in hollywood ca this weekend	hollywood	hollywood
where did kim kardashian come from	kim kardashian	kim kardashian
what town did justin bieber grew up in	justin bieber	justin bieber
who plays charlie in the santa clause movies	charlie	the santa clause
what highschool did r. kelly attend	r. kelly	r. kelly
what happened at benghazi	benghazi	benghazi
what country is nike based in	nike based in	nike based in
what kind of money do i bring to mexico	mexico	mexico
who did steve spurrier play pro football for	steve spurrier	steve spurrier
where do the blackhawks play	the blackhawks	the blackhawks
who plays john connor	john connor	john connor
what is the main language spoken in mexico	mexico	mexico
what are italians classified as	italians	italians
what has angelina jolie accomplished	angelina jolie	angelina jolie
who played captain kirk in star trek movie	captain kirk	captain kirk
who played dana scully in x files	x files	dana scully
what was f. scott fitzgerald	f. scott fitzgerald	f. scott fitzgerald
what is the dominant language spoken in jamaica	jamaica	jamaica
who is the coach for the new york knicks	new york knicks	new york knicks
who was wesley snipes	wesley snipes	wesley snipes
where does sherrod brown live	sherrod brown	sherrod brown
what kind of language does colombia speak	colombia	colombia
what currency does england use now	england	use now
who was the original voice of meg griffin on family guy	meg griffin	meg griffin
what kind of government is mali	mali	mali
who did cristiano ronaldo play for in 2010	cristiano ronaldo	cristiano ronaldo
what is the zip code for morgantown wv	morgantown	morgantown
what is jacksonville fl timezone	jacksonville	jacksonville
who does amy stiller play in dodgeball	amy stiller	dodgeball
who were king henry vii children	henry vii children	henry vii children
who does mila kunis play on family guy	family guy	family guy
who played damien in the omen 2006	the omen	the omen
who played denver in four christmases	denver	four christmases
what to do with kids in essex	with kids	essex
who did the cleveland cavaliers draft	cleveland cavaliers	cleveland cavaliers
what concentration camp did anne frank died in	anne frank	anne frank
what language does east timor speak	east timor	timor speak
what is the currency in italy	italy	italy
where does greek language come from	greek	greek language
what is the name of the currency used in italy	italy	italy
where is audrey hepburn from	audrey hepburn	audrey hepburn
who does darth vaders voice	darth vaders	darth vaders
what school did douglas macarthur go to	douglas macarthur	douglas macarthur
what famous people are from barbados	barbados	barbados
what is the name of the currency used in china	china	china
what are the names of michael jackson 's 3 children	michael jackson	michael jackson
who is the current governor of arizona 2010	arizona	arizona
who is lamar odom playing for this year	lamar odom	lamar odom
where were the great pyramids of giza built	great pyramids	great pyramids of giza
what language do the russian speak	russian	russian
what language do australia people speak	australia	australia
what country was king tut 's tomb found	tut	king
where did abraham and his descendants live	abraham	abraham
where did george washington carver go to collage	george washington carver	george washington carver
what are the sports in spain	spain	spain
where president obama was born	president obama	obama
what sports do people play in poland	poland	poland
who was demi lovato dating	demi lovato	demi lovato
what films has scarlett johansson been in	scarlett johansson	scarlett johansson
who originally voiced meg on family guy	meg on	family guy
who played amy squirrel in bad teacher	bad teacher	bad teacher
where are boeing headquarters	boeing	boeing
what type of religions are in the united states	united states	united states
who did viggo mortensen play in lord of the rings	viggo mortensen	in lord of the rings
who was isaac newton and what did he do	isaac newton	isaac newton
who did william shakespeare marry	william shakespeare	william shakespeare
what movies queen latifah is in	queen latifah	queen latifah
where did michelle obama graduated from	michelle obama	michelle obama
what kind of music did franz liszt compose	franz liszt	franz liszt
what country does david luiz play for	david luiz	david luiz
what document did thomas jefferson wrote	thomas jefferson	thomas jefferson
who is martin luther king jr facts	martin luther king jr	martin luther king jr
where is victoria british columbia	victoria	victoria
how many mary mary sisters	mary mary sisters	mary mary
what do we call the currency of france	france	france
what team does david beckham play for in 2012	david beckham	david beckham
what movies did nick cannon star in	nick cannon	nick cannon
what radio station is npr on in nyc	npr	npr
who did tom landry play for	tom landry	tom landry
where was john jay born	john jay	john jay
where is mount fuji located	mount fuji	mount fuji
where was toussaint l'ouverture born	toussaint l'ouverture	toussaint l'ouverture
what countries makes up the uk	countries	up the uk
what is lawton ok zip code	lawton	lawton
what is the capital city of spain wiki answers	spain	spain
where do they speak german	german	german
when did mark mcgwire retired	mark mcgwire	mark mcgwire
what is colorado technical university	colorado	colorado technical university
what was the currency used in france before the euro	france	france
what is kentucky state slogan	kentucky state	kentucky
who played samantha stephens in bewitched	bewitched	bewitched
what area of science did sir isaac newton study	isaac newton	isaac newton
what county is san diego in	san diego	san diego in
which country in north america is divided into provinces	north america	north america
what is real name of santa claus	santa claus	santa claus
what did coretta scott king died from	coretta scott king	coretta scott king
what does wh smith stand for	wh smith	wh smith
who was vp for nixon	nixon	for nixon
what religion did adolf hitler follow	adolf hitler	adolf hitler
where is the illinois river on a map	illinois river	illinois river
where honduras in the world	honduras	honduras
who does ronaldinho play for now 2011	ronaldinho	ronaldinho
what galileo galilei was famous for	galileo galilei	galileo galilei
what are the major trading partners of germany	germany	germany
where did romney graduated college	romney	did romney
who did johnny depp play in corpse bride	corpse bride	corpse bride
what is the zip code for jonesboro ar	jonesboro	jonesboro
what college did se hinton go	se hinton	se hinton
where did charles darwin and his wife live	charles darwin	charles darwin
who is the voice of kitt	kitt	kitt
who is amy grant 's first husband	amy grant	amy grant
what are the seven nations of central america	central america	central america
what is jamie spears baby name	jamie spears	jamie spears
who is the mother of prince michael jackson	michael jackson	michael jackson
what is the clemson mascot name	the clemson	clemson mascot
what rainforest is in south america	south america	south america
what type of art does claude monet do	claude monet	claude monet
what guitar did kurt cobain	kurt cobain	kurt cobain
who did jennifer lawrence play in x men	x men	jennifer lawrence
who is the governor of virginia 2011	governor of virginia	virginia
who did darth vaders voice	darth vaders	darth vaders
where is walton county ga	walton county	walton county
what cancer did jackie kennedy die of	jackie kennedy	jackie kennedy die
what does lauren conrad major in	lauren conrad	lauren conrad
what time zone is pennsylvania in right now	pennsylvania	pennsylvania
where did mario lopez go to school	mario lopez	mario lopez
where is tupac from originally	tupac from	tupac from
what role did george lucas play in star wars	george lucas	george lucas
what sarah dessen books are movies	sarah dessen	sarah dessen
what is the current time in kauai hawaii	kauai	hawaii
where was farrah fawcett buried	farrah fawcett	farrah fawcett
what inspired steinbeck	steinbeck	steinbeck
what kind of government does cuba have today	cuba	cuba
where are english speakers distributed	english speakers	english speakers
what is the capital of italy today	italy	italy
what language do people speak in the bahamas	bahamas	bahamas
where did george michael go to school	george michael	george michael
what club does cristiano ronaldo play for in 2010	cristiano ronaldo	cristiano ronaldo
what time zone is in the bahamas	bahamas	bahamas
what language do people speak in brazil	brazil	brazil
who influenced samuel taylor coleridge	samuel taylor coleridge	samuel taylor coleridge
what does kim kardashian work as	kim kardashian	kim kardashian
where did the mississippi river end	mississippi river	mississippi river
who played carlton lassiter on psych	psych	psych
who is president of israel	israel	israel
where did the anasazi indians live	anasazi	anasazi indians
who plays harley quinn	harley quinn	harley quinn
what was francis bacon contributions	francis bacon	francis bacon
when does ziva start on ncis	ncis	ncis
what is the name of the national anthem of canada ( 2 words )	canada	canada
what did mark zuckerberg study	mark zuckerberg	mark zuckerberg
which country was michael jackson born	michael jackson	michael jackson
who was stephen r covey	stephen r covey	stephen r covey
what country was stalin in charge of	stalin	was stalin
what is monta ellis career high points	monta ellis	monta ellis
what nationality is rihanna	rihanna	rihanna
what has shannen doherty played in	shannen doherty	shannen doherty
what college did joakim noah	joakim noah	joakim noah
who plays billy elliot	billy elliot	billy elliot
what kourtney kardashian boyfriends name	kourtney kardashian	kourtney kardashian
what form of government does australia use	australia	australia
what team did howie long	howie long	howie long
where did the greek alphabet come from	greek alphabet	greek alphabet
what timezone is elizabethtown kentucky	elizabethtown	elizabethtown
what to see in christchurch new zealand	christchurch	christchurch
where is chris paul from	chris paul	chris paul
what year was albert pujols rookie year	albert pujols	albert pujols
what are the colors of the ny giants	ny giants	ny giants
what was sir isaac newton 's inventions	isaac newton	isaac newton
who did shaq first play for	shaq first	shaq first play for
who was the artist of mickey mouse	mickey mouse	mickey mouse
what is the zip code for concord	concord	concord
what football team is michael vick on	michael vick	michael vick
where does the columbia river start	columbia river	columbia river
what are all the names of the harry potter books	harry potter	harry potter
who was sir walter raleigh and what did he do	walter raleigh	walter raleigh
what countries are in the euro dollar	euro	euro
what currency can you use in barbados	barbados	barbados
who is angelina jolie	angelina jolie	angelina jolie
where is nineveh city	nineveh city	nineveh
what is the state flower of new mexico	new mexico	new mexico
where is the national ffa foundation located today	ffa foundation	national ffa foundation
which countries speak germanic languages	germanic languages	germanic languages
who plays eowyn in lord of the rings	eowyn	in lord of the rings
where is augusta masters 2012	augusta	masters
what type of cancer did eva peron die from	eva peron	eva peron
who did terrell owens play for in 2010	terrell owens	terrell owens
where is denmark south carolina	denmark	denmark
what books did ernest hemingway write	ernest hemingway	ernest hemingway
what year did baltimore ravens win super bowl	baltimore ravens	baltimore ravens
where did the battle of passchendaele happen	battle of passchendaele	battle of passchendaele
what part of the country is ohio considered	ohio	ohio
what team is cristiano ronaldo play for	cristiano ronaldo	cristiano ronaldo
what standard time is michigan	michigan	michigan
what was john tyler	john tyler	john tyler
what did romo do	romo	did romo
what currency can you use in jamaica	jamaica	jamaica
where did jay moriarty die	jay moriarty	jay moriarty
where was the boston tea party 1773	boston tea	boston tea party
what drugs lindsay lohan abuse	lindsay lohan	lindsay lohan
when did carolina panthers go to superbowl	superbowl	carolina panthers
who won the governor election in texas	texas	texas
what does helen flanagan do	helen flanagan	helen flanagan
when are the summer and winter olympics held	winter olympics	olympics
where is tennessee river	tennessee river	tennessee river
what are some major events in venezuela	venezuela	venezuela
what guitar does corey taylor play	corey taylor	corey taylor
who was president after franklin d. roosevelt	franklin d. roosevelt	franklin d. roosevelt
where did kate gosselin grew up	kate gosselin	kate gosselin
under what political system does the united states government operate	united states government	united states government
what to do in paris in 1 day	paris	paris
what city is mt lassen in	mt lassen	lassen
what is the state motto of ohio	ohio	ohio
what type of music did mozart composed	did mozart	of music did mozart
how many kids were there in the kennedy family	kennedy family	the kennedy
which barcelona airport is closest to the port	barcelona airport	barcelona
where has the english language evolved from	english language	english language
what country did hitler invade that started ww2	hitler	country did hitler invade
what does matt damon play in	matt damon	matt damon
what was scottie pippen known for	scottie pippen	scottie pippen
what continent does canada belong to	canada	canada
what does george wilson do for a living	george wilson	george wilson
what city does fulham play in	fulham	fulham
what are fun things to do in sacramento ca	sacramento	sacramento
what other movies is josh hutcherson in	josh hutcherson	josh hutcherson
what was hitler the leader of	was hitler	was hitler
what awards did marilyn monroe won	marilyn monroe	marilyn monroe
what kind of government does iran have after 1979	iran	iran
where did harper lee attend high school	harper lee	harper lee
what college did jrr tolkien go to	jrr tolkien	jrr tolkien
what art did wassily kandinsky do	wassily kandinsky	wassily kandinsky
who won the league cup in 2002	league cup	the league cup
what was antoni gaudi inspired by	antoni gaudi	antoni gaudi
in what country do people speak danish	danish	danish
who were demeter 's siblings	demeter	demeter
where should a family stay in paris	paris	paris
what was the name of benjamin franklin wife	benjamin franklin	benjamin franklin
what the largest city in spain	spain	spain
who has pudge rodriguez played for	rodriguez	rodriguez
what is the milwaukee brewers stadium called	milwaukee brewers stadium	milwaukee brewers
where did the gallipoli war take place	gallipoli war	gallipoli war
what other movies has tom hardy played in	tom hardy	tom hardy
what to visit in atlanta	atlanta	atlanta
what college did john nash go to	john nash	john nash go
what language do maltese speak	maltese speak	maltese
what did thomas edison do for the world	thomas edison	thomas edison
where is shakira from	shakira	shakira
what did hayes do	hayes	did hayes
who played bilbo in the fellowship of the ring	fellowship	played bilbo
what is the most populated state in united states	united states	united states
who is my state senator arizona	arizona	arizona
where does the tennessee river go	tennessee river	tennessee river
who did tom hanks play in apollo 13	tom hanks	apollo 13
what language do they in ghana	ghana	ghana
what is utah 's state capitol	utah	utah
what all did ben franklin invent	ben franklin	ben franklin
what team does jeremy lin play for 2013	jeremy lin	jeremy lin
what is steve nash nationality	steve nash	steve nash
who are the u s senators of pennsylvania	pennsylvania	pennsylvania
what kind of language does france speak	france	france
what degree did martin luther king earn	martin luther king	martin luther king
what two states is st louis in	st louis	st louis
what team did peyton manning 's dad play for	peyton manning	peyton manning
what did jesse owens won	jesse owens	jesse owens
what is the name of the currency used in peru	peru	peru
what are the four nations of the united kingdom	united kingdom	united kingdom
who is judy garland father	judy garland	judy garland
what school did robert f kennedy go to	robert f kennedy	robert f kennedy
what drug killed marilyn monroe	marilyn monroe	marilyn monroe
where is the fukushima daiichi nuclear power station	fukushima daiichi nuclear power station	fukushima daiichi nuclear power
what is los angeles california time zone	los angeles	los angeles
what did nicolas cage name his son	nicolas	nicolas cage
what currency should take to mexico	mexico	mexico
who is the state governor of florida	florida	florida
who was jessica simpson married too	jessica simpson	jessica simpson
what do they speak in scotland	scotland	scotland
what did john dalton study	john dalton	john dalton
what songs do zac brown band sing	zac brown	zac brown band
where is glastonbury england	glastonbury	glastonbury
who formed the american federation of labor	american federation of labor	american federation of labor
what to visit in denver	denver	denver
where did thomas hobbes live	thomas hobbes	thomas hobbes
where was john f kennedy when he got shot	john f kennedy	john f kennedy
what type of government does italy have 2011	italy	italy
what province is montreal canada located	montreal	montreal
who does kellan lutz play in prom night	prom night	kellan lutz
what did franz liszt do to earn a living	franz liszt	franz liszt
what was nikola tesla known for	nikola tesla	nikola tesla
what is the zip code for princeton nj	princeton	princeton
what other countries border argentina	argentina	argentina
what language does people in iceland speak	iceland	iceland
what is the predominant religion in israel	israel	israel
who has coached the carolina panthers	carolina panthers	carolina panthers
what time zone is toronto gmt	toronto	toronto
what country did toussaint l'ouverture help free	toussaint l'ouverture	toussaint l'ouverture
what jobs did robert burns have	robert burns	robert burns
who won utah attorney general	attorney	utah
what the language spoken in indonesia	indonesia	indonesia
who coaches the carolina panthers	carolina panthers	carolina panthers
what other countries does south africa share borders with	south africa	south africa
who played darth vader at the end of return of the jedi	darth vader	darth vader
what movies did joan crawford play in	joan crawford	joan crawford
what products does the united states export	united states export	united states export
what is the kentucky state bird	kentucky	kentucky
who was canadian prime minister in 1993	canadian	prime minister in
what there to do in salt lake city utah	salt lake city	salt lake city
who is the current ohio state senator	ohio	ohio state senator
what are the major languages spoken in the united kingdom	united kingdom	united kingdom
what did st . nicholas do in his life	st . nicholas do	st . nicholas
what happened to pope john paul ii	john paul ii	pope john paul ii
what was franklin pierce famous for	franklin pierce	franklin pierce
when was the last time the boston bruins went to the stanley cup	stanley cup	boston bruins
who is meredith gray married to in real life	meredith gray	meredith gray
what inspired michelangelo buonarroti	michelangelo buonarroti	michelangelo
what does monsanto own	monsanto	monsanto
who did woody harrelson play on cheers	cheers	cheers
what language do they speak in sweden yahoo	sweden	sweden
what language did they speak in ghana	ghana	ghana
what form of government do we have in the philippines	philippines	philippines
what colleges did mitt romney attend	mitt romney	mitt romney
where is ibrahim afellay from	ibrahim afellay	ibrahim afellay
who was the secretary of state when andrew jackson was president	andrew jackson	andrew jackson
what currency is accepted in new zealand	new zealand	new zealand
what places are in the west midlands	west midlands	west midlands
what to do with kids in asheville nc	asheville	asheville
who is in the american league in baseball	american league in	american league
who did kurt warner play 4	kurt warner	kurt warner
who is dirk nowitzki wife	dirk nowitzki	dirk nowitzki
where all did picasso live	did picasso	all did picasso
what currency shall i take to croatia	croatia	croatia
what team is raul ibanez on	raul ibanez	raul ibanez
what tv series did mark harmon star in	mark harmon	mark harmon
who plays anakin skywalker in star wars 1	skywalker in star wars 1	star wars
where does michelle pfeiffer live now	michelle pfeiffer	michelle pfeiffer
what was laura ingalls wilder famous for	laura ingalls wilder	laura ingalls wilder
where is dwight howard now	dwight howard	dwight howard
who is nick lachey married to	nick lachey	nick lachey
where did madonna grew up	madonna	madonna
what capital city of brazil	brazil	brazil
what college did john stockton go to	john stockton	john stockton
what kind of currency does mexico use	mexico	mexico
who owns chrysler corporation 2011	chrysler	chrysler
what are some books that mark twain wrote	mark twain	mark twain
what was gregor mendel contribution	gregor mendel contribution	gregor mendel
who has ray allen dated	ray allen	ray allen
who is running for vice president with barack obama 2012	barack obama	barack obama
what language do people from the uk speak	from	language do
what to do with my kids in toronto	toronto	toronto
what kind of government is south korea	south korea	south korea
who did ben franklin marry	ben franklin	ben franklin
what sri lanka capital	sri lanka	sri lanka
what kind of government does poland have	poland	poland
what famous people came from delaware	delaware	delaware
what currency does cyprus use	cyprus	cyprus
what type of guitar does johnny depp play	johnny depp	johnny depp
what episode of how i met your mother is carrie underwood on	carrie underwood	carrie underwood
who are the 9 justices of the supreme court 2011	supreme court	supreme court
who is dustin johnson the golfer	dustin johnson	dustin johnson
who did cher have a son with	cher	cher
what city is the university of oregon state in	what city is the university	university of oregon
who played carmen cortez in spy kids	spy kids	spy kids
what is the political system in germany	germany	germany
what prompted shakespeare to write poetry	prompted shakespeare	shakespeare
what is the currency in turkey called	turkey	turkey
what school did mark zuckerberg attend	mark zuckerberg	mark zuckerberg
where does kate middleton live 2012	kate middleton	where does kate middleton
what type of art does marc chagall do	marc chagall	marc chagall
what character did billy d williams play in star wars	billy d williams	billy d williams
what language is spoken in argentina	argentina	argentina
what school did wilfred owen go to	wilfred owen	wilfred owen
who is kevin jonas married to	kevin jonas	kevin jonas
where does airtran airways fly	airtran airways	airtran airways
where does the city of paris get its name	the city of paris	paris
who did sandra bullock marry	sandra bullock	sandra bullock
where is olympic national park located	olympic national park	olympic national park
where is the un based	un	is the un based
what city and state is yale located in	state	is yale
where did thomas paine die	thomas paine	thomas paine
where was barack hussein obama sr born	obama	barack hussein obama sr
where is the home stadium of the new england patriots	new england patriots	new england patriots
who was kate chopin	kate chopin	kate chopin
when did bill clinton go to college	bill clinton	bill clinton
what are staffordshire terriers	staffordshire terriers	staffordshire terriers
what to do downtown sacramento	sacramento	sacramento
who is michael j fox parents	michael j fox	michael j fox
where did sanjay gupta go to school	sanjay gupta	sanjay gupta
what countries are involved in the nafta	nafta	what countries are
what continent is cayman islands located	cayman islands	cayman islands
what language speak in brazil	brazil	brazil
who does kroy biermann play football for	kroy biermann	kroy biermann
when is the last time the pittsburgh steelers won a superbowl	pittsburgh steelers	pittsburgh steelers
who invented islamic religion	islamic	islamic
who were we fighting in the gulf war	gulf war	gulf war
how many languages do they speak in switzerland	switzerland	switzerland
what political party does barack obama represent	barack obama	barack obama
what movies does logan lerman play in	logan lerman	logan lerman
where did emperor constantine die	constantine	constantine die
where is mali located	mali	mali
what planet did luke skywalker came from	luke skywalker	luke skywalker
who are the coaches for the oakland raiders	oakland raiders	oakland raiders
where was the first microsoft headquarters located	microsoft	microsoft
where did john steinbeck go to college	john steinbeck	john steinbeck
what did niels bohr discover about the atomic structure	niels bohr	niels bohr discover
what books did louis sachar wrote	louis sachar	louis sachar
who is ryan reynolds married to 2012	ryan reynolds	ryan reynolds
what is newt gingrich 's wife 's name	newt gingrich	newt gingrich
what type of music did antonio vivaldi play	antonio vivaldi	antonio vivaldi
what school does james franco go to	james franco	james franco
what is samuel langhorne clemens well known for	samuel langhorne clemens	known
who was president after william henry harrison	william henry harrison	president after william
where did rick santorum attend high school	rick santorum	rick santorum
what is the title of george bush 's new book	george bush	george bush
where did antoine lavoisier die	antoine lavoisier	antoine lavoisier
what is the name of king george vi wife	george vi	george vi
what year did seattle seahawks go to the super bowl	seattle seahawks	seattle seahawks
where does sami yusuf live	sami yusuf	sami yusuf
what is the official language of brazil now	brazil	brazil
when 's the last time the mets won the world series	the mets	the mets
where do florida panthers play	florida panthers	florida panthers
who is john cena married to	john cena	john cena
what to do san jose ca	san jose	san jose
who founded new york university	new york university	new york university
who created arthur	arthur	arthur
what countries constitute the eu	countries constitute	what countries
what are all the countries in north africa	north africa	north africa
what did bobby darin die of	bobby darin	bobby darin
where does houston dynamo play	houston dynamo	houston dynamo
what kind of guitar john mayer	john mayer	john mayer
what cancer did patrick swayze	patrick swayze	patrick swayze
what university did obama graduated from	obama	obama
what jamaican money called	jamaican	jamaican
where is the arizona cardinals stadium located	arizona cardinals	arizona cardinals
what is sir isaac newton theory	isaac newton	isaac newton
what should i do today in san francisco	san francisco	san francisco
who influenced picasso art	influenced picasso	picasso
what is my timezone in pennsylvania	pennsylvania	pennsylvania
what products and\/or services does google offer customers	and\/or	google
who did cliff lee play for last year	cliff lee	cliff lee
what type of democracy is the united states	united states	united states
what time in china hong kong	china hong	hong kong
what all movies has taylor lautner been in	taylor lautner	taylor lautner
what disease did bernie mac die of	bernie mac	bernie mac
who plays spike spiegel	spiegel	spike spiegel
who was queen isabella 's mother	isabella	isabella 's mother
who does chris hemsworth have a baby with	chris hemsworth	chris hemsworth
what are the most popular religions in israel	israel	israel
what was obama 's former occupation	was obama	was obama
what are all the songs justin bieber wrote	justin bieber	justin bieber
where is the thames river source	the thames	the thames
what new movies is robert pattinson in	robert pattinson	robert pattinson
what language do they use in pakistan	pakistan	pakistan
what kind of products does nike sell	nike sell	nike
who did lbj marry	did lbj	did lbj
where did kim jong il die	kim jong	kim jong il
what is the sacred text of daoism	daoism	daoism
what countries speak english natively	english natively	english natively
who won fedex cup 2012	fedex cup	fedex cup
what language is mainly spoken in egypt	egypt	egypt
who played alf on tv show	alf	alf
who was gerald ford vp	gerald ford	gerald ford
what is armenian currency	armenian	armenian
what type of art did raphael sanzio create	raphael sanzio	raphael
what language do they speak in malta	malta	malta
what religion was king louis xiv	louis xiv	louis xiv
what football team does mike wright play for	mike wright	mike wright
what did shannon hoon die from	shannon hoon	shannon hoon
what did nicholas copernicus discover	nicholas copernicus	nicholas copernicus
what teams has manny ramirez played for	manny ramirez	manny ramirez
where do the appalachian mountains run	appalachian mountains	appalachian mountains
what political party is jerry brown	jerry brown	jerry brown
what ocean is around hawaii	hawaii	hawaii
what is the most common language spoken in argentina	argentina	argentina
what language tunisia	tunisia	tunisia
what are some inventions that leonardo da vinci invented	leonardo da vinci	leonardo da vinci
what are malaysian coins called	malaysian	malaysian
what type government does mexico have	mexico	mexico
what currency does dominican republic take	dominican republic	dominican republic
what inspired michael jackson to become a singer	michael jackson	michael jackson
who is the texas state senator	texas	texas
what to visit in london city	london city	london
what genre of art is the mona lisa	mona lisa	mona lisa
who does peter griffin voice	peter griffin	peter griffin
what are the catholic holy days	catholic	catholic
what language is most commonly spoken in belgium	belgium	belgium
where did frank baum die	frank baum	frank baum
where is tunis on a map	tunis	tunis
who is nicolas cage married too	nicolas cage	nicolas cage
who does the voice for chucky in child 's play	child 's	child 's play
what did mary wollstonecraft fight for	mary wollstonecraft	mary wollstonecraft
what language does iceland speak	iceland	iceland
what did gloria steinem founded	gloria steinem	gloria steinem
what language they speak in scotland	scotland	scotland
what boarding school did mark zuckerberg go to	mark zuckerberg	mark zuckerberg
what are bigos	bigos	bigos
where are ike and tina turner 's children	tina turner	tina turner
what are some of leonardo da vinci most famous inventions	leonardo da vinci	leonardo da vinci
when did shaq come into the nba	shaq come	shaq come
where do they speak turkish	turkish	turkish
what is the zip code for walnut creek	walnut creek	walnut creek
who was the voice of darth vader in the original star wars movie	darth vader in the original star wars	darth vader
where is english spoken around the world	english spoken	english
what music did louis armstrong play	louis armstrong	louis armstrong
what form of currency does germany use	germany	germany
where is the latin language from	latin language	latin language
what are the top tourist attractions in rome	rome	rome
who were the children of king solomon	solomon	solomon
what did andy irons die from	andy irons	andy irons
where is auburn university located	auburn university	auburn university
who is tatyana ali parents	tatyana ali	tatyana ali
where did leif ericson grow up	leif ericson	leif ericson
what language do the maasai speak	maasai	maasai speak
what political party was hitler in	was hitler	was hitler
who is the leader of north korea today	north korea	north korea
where do the appalachian mountains run through	appalachian mountains	appalachian mountains
what money does spain use	spain	spain
where was terry waite born	terry waite	terry waite
what country did the battle of san juan hill take place	battle of san juan hill	battle of san juan hill
what kind of government does the united states have currently	united states have	united states have
when was the last time the orioles won the world series	the orioles	time the orioles
who did ben stiller date	ben stiller	ben stiller
what is the most common language in norway	norway	norway
what influenced william shakespeare to start writing	william shakespeare	william shakespeare
where did benjamin franklin went to school	benjamin franklin	benjamin franklin
who is the governor of arizona 2009	arizona	arizona
what movies has spike lee made	spike lee	spike lee
what did bernie mac died of	bernie mac	bernie mac
where is electrolux based	electrolux	electrolux
what is houston timezone	houston	houston
what was shakespeare 's wife called	was shakespeare	was shakespeare
what did ferdinand magellan do	ferdinand magellan	ferdinand magellan
where do burmese cats originate from	burmese cats	burmese cats
who played kirk	kirk	played kirk
where is mt st helens located	mt st helens	mt st helens
what county is st paul minnesota in	paul minnesota	st paul
who was king henry viii son	henry viii son	henry viii son
where was franz ferdinand from	franz ferdinand	franz ferdinand
what was benedict arnold most famous for	benedict arnold	benedict arnold
who plays lex luthor on smallville	smallville	smallville
what are dallas cowboys colors	dallas cowboys	dallas cowboys
what is the currency of the czech republic	czech republic	czech republic
when was the last time the la kings won a playoff series	la kings	la kings
where did spencer pratt go to school	spencer pratt	spencer pratt
what disease did abraham lincoln had	abraham lincoln	abraham lincoln
who is vancouver canucks coach	vancouver	vancouver canucks
where did cs lewis wrote	cs lewis	cs lewis
what is carlos pena jr nationality	carlos pena jr	carlos pena
who was married to jane wyman	jane wyman	jane wyman
what language does peru speak	peru	peru
where is english spoken in the world map	english spoken	english
when did arsenal won the league	arsenal	arsenal
what timezone is phoenix az in right now	phoenix	phoenix
where is south portland	south portland	south portland
what countries speak french as a first language	french	french
who was ptolemy and what did he do	NOT FOUND	ptolemy
what was the name of henry viii first wife	henry viii	henry viii first wife
where does the parana river flow	parana river	parana river
where did theodor schwann get his education	theodor schwann	theodor schwann
who or what influenced frank lloyd wright	frank lloyd wright	frank lloyd wright
what year did houston rockets win their first championship	houston rockets	houston rockets
where do most of the people live in russia	russia	russia
where is holy roman empire located	roman empire	holy roman empire
what movies has liam hemsworth played in	liam hemsworth	liam hemsworth
who plays nicholas newman on the young and the restless	the young and the restless	the young and the restless
who is the voice of eric cartman on south park	south park	south park
who is angelina jolies brother	angelina jolies	angelina jolies
where is the headquarters of bank of america	america	bank of america
what type of government japan have	japan	japan
what team does josh hamilton play for	josh hamilton	josh hamilton
where is burundi country	burundi	burundi
through which countries of the sahel does the niger river flow	niger river	niger river
what city does paul ryan live in	paul ryan	paul ryan
what city is acadia university in	acadia university	acadia university
what did f. scott fitzgerald do	f. scott fitzgerald	f. scott fitzgerald
what countries does tomtom western europe include	western europe	tomtom
what is the national language of iran	iran	iran
where did the second battle of ypres occur	battle of ypres	second battle of ypres
what languages do people speak in spain	spain	spain
what did michael crabtree do	michael crabtree	michael crabtree
where do they speak afrikaans	speak afrikaans	afrikaans
what 3 states border florida	florida	florida
who plays ziva david on ncis	ncis	who plays ziva david
who ruled after king henry viii died	henry viii died	henry viii died
who are the st louis cardinals coaches	st louis cardinals	st louis cardinals
where is daud ibrahim	daud ibrahim	daud ibrahim
what region is turkey considered	turkey	turkey
what language do russians speak	russians	russians
where was martin luther king jr buried	martin luther king jr	martin luther king jr
what are the official languages of argentina	argentina	argentina
where is the city wales	city wales	wales
what country does rafael nadal play for	rafael nadal	rafael nadal
what is the islamic belief	islamic	islamic
who is the prime minister of spain 2011	spain	spain
who was the son of king leonidas	leonidas	leonidas
who was judi dench married to	judi dench	judi dench
how many languages do they speak in spain	spain	spain
where are the sahara desert located	sahara desert	sahara
what is rihanna mum called	rihanna	rihanna
who does michael oher play for in 2010	michael oher	michael oher
who or what influenced albert einstein	albert einstein	albert einstein
where does egypt export to	egypt	egypt
where is the seat of the african union	african union	african union
what was kim richards in	kim richards	kim richards
what artistic style did henri rousseau work in	henri rousseau	henri rousseau
what is john edwards indicted for	john edwards	john edwards
where was huey newton killed	huey newton	huey newton
where is midlothian scotland	midlothian	midlothian
where does marta play soccer	marta	marta
where is mitt romney 's family from	mitt romney	mitt romney
what are john terry 's children called	john terry	john terry
what city was michael jackson born in	michael jackson	michael jackson
who fought in the battle of vicksburg	of vicksburg	of vicksburg
what kind of writing is nikolai gogol famous for	nikolai gogol	nikolai gogol
what year was first world series	world series	world series
who plays simon birch	simon birch	simon birch
where are the timezones in the usa	are the timezones in the	the timezones in the usa
what does gm make	gm	what does
what do people speak in uk	uk	what do
what do people in jamaica speak	jamaica	jamaica
what position did lebron james play	lebron james	lebron james
what was wayne gretzky 's first team	wayne gretzky	wayne gretzky
who is the president of peru now	peru	peru
what kind of guitar did jerry garcia play	jerry garcia	jerry garcia
what type of art leonardo da vinci do	leonardo da vinci	leonardo da vinci
who are the senators of new jersey now	new jersey	new jersey
where was rihanna raised	rihanna	rihanna
what team does messi play for 2011	does messi	does messi
where does lil wayne go to school	lil wayne	lil wayne
where did jrr tolkien go to school	jrr tolkien	jrr tolkien
what state is saint louis university in	saint louis university	saint louis university
what religion does canada follow	canada	canada
which countries have spanish as their main language	spanish as	main language
who is in paul ryan 's family	paul ryan	paul ryan
what government does iraq use	iraq	iraq
what type of currency do they use in spain	spain	spain
what did lincoln steffens wrote	lincoln steffens	lincoln steffens
what schools did anders celsius attend	anders celsius	anders celsius
what can do in new york	new york	new york
what currency does france accept	france	france
what type of religion did massachusetts have	massachusetts	massachusetts
what language do they speak in colombia south america	colombia	colombia
what kind of government does brazil has	brazil	brazil
what country did gregor mendel live in	gregor mendel	gregor mendel
where laura ingalls wilder lived	laura ingalls wilder	laura ingalls wilder
what sports are popular in germany	germany	germany
what 's my timezone in oklahoma	oklahoma	oklahoma
what do they speak in norway	norway	norway
what currency does singapore use	singapore	singapore
what did the blackfoot indians speak	blackfoot	blackfoot indians
who plays robin hood in prince of thieves	robin	robin hood in prince of thieves
what standard time is texas	texas	texas
where does kurdish people live	kurdish	kurdish
what instrument does louis armstrong	louis armstrong	louis armstrong
who does alyson stoner play in camp rock	camp rock	camp rock
what religion does madonna practice	madonna	madonna
what countries are located near egypt	egypt	egypt
what made richard hammond famous	richard hammond	richard hammond
who originally voiced lois griffin	lois griffin	lois griffin
what airport do you fly into in paris	paris	paris
what rihanna new album called 2012	rihanna	rihanna
where does dave ramsey live	dave ramsey	dave ramsey
what discovery did galileo make	galileo make	galileo make
what is the government system of saudi arabia	saudi arabia	saudi arabia
who plays the role of tony dinozzo on ncis	ncis	role of tony dinozzo
what did jesus do for living	jesus do	jesus do
what is the state name of new york city	new york city	new york city
what movies did david carradine play in	david carradine	david carradine
what is the stanley cup named after	the stanley cup	stanley cup
where is traditional chinese used	chinese	chinese used
who does portugal trade with	portugal	portugal
what type of political system is brazil	brazil	brazil
what language did the ancient babylonians speak	babylonians	babylonians
what kind of painter was wassily kandinsky	wassily kandinsky	wassily kandinsky
what form of government does the united states use	united states use	united states use
what money does cuba use	cuba	cuba
who is my representative in illinois house	illinois	is my representative
what timezone is sweden gmt	sweden	sweden
what was franklin d roosevelt 's job before president	franklin d roosevelt	franklin d roosevelt
where did robert downey jr go to jail	robert downey jr	robert downey jr
what degrees did barack obama get	barack obama	barack obama
what does god shiva represent	shiva	shiva
what inventions were made by ben franklin	ben franklin	ben franklin
what is the name of the currency used in switzerland	switzerland	switzerland
what year did the milwaukee brewers go to the world series	milwaukee brewers	world series
who was vice president with bill clinton	bill clinton	bill clinton
what songs did franz liszt compose	franz liszt	franz liszt
where did the russian japanese war happen	russian japanese war	russian japanese war
what year did the la kings win the cup	la kings	la kings
what kind of money does egypt have	egypt	egypt
what baseball team was jackie robinson on	jackie robinson	jackie robinson
what body of water does st lawrence river flow into	st lawrence river	st lawrence river
what form of government does the united states have	united states have	united states have
what are the names of ariel 's six sisters	ariel	ariel
what voices does seth macfarlane play on family guy	family guy	family guy
who was william mckinley married to	william mckinley	william mckinley
who played darth vader in the first movie	darth vader	darth vader
where did kevin james go to college	kevin james	kevin james
what 's there to see in atlanta	atlanta	atlanta
where was auschwitz concentration camp located	auschwitz concentration camp	auschwitz concentration camp
what kind of currency does dominican republic use	dominican republic	dominican republic
what is spoken in czech republic	czech republic	czech republic
where was shakespeare born at	was shakespeare	was shakespeare
where did scott fitzgerald go to college	scott fitzgerald	scott fitzgerald
what did joan crawford died of	joan crawford	joan crawford
where did rob kardashian go to school	rob kardashian	rob kardashian
what year was allen iverson mvp	allen iverson	allen iverson
where did harry s truman go to school	harry s truman	harry s truman
what county is utica ny in	utica	utica
what did charles babbage discover	charles babbage	charles babbage
who plays king julian madagascar	julian madagascar	madagascar
who is rick scott	rick scott	rick scott
where did the crimean war take place	crimean war	crimean war
what offices did theodore roosevelt hold	theodore roosevelt	theodore roosevelt
what movies has miley cyrus been in	miley cyrus	miley cyrus
who did james franco play in milk	james franco	milk
what wnba team is diana taurasi on	diana taurasi	diana taurasi
what do see in paris	paris	paris
who made the laws in canada	canada	canada
what year did adam morrison get drafted	adam morrison	adam morrison
where michael jackson from	michael jackson	michael jackson
what college did maya moore go to	maya moore	maya moore
when was the last time the dodgers won a championship	dodgers	last time the dodgers
who is captain james cook facts	james cook	james cook
where did robin williams get married	robin williams	robin williams
what form of government does canada	canada	canada
who do islamic people follow	islamic	islamic
what kind of government does peru	peru	peru
who was in the israeli palestinian conflict	palestinian conflict	israeli palestinian conflict
who founded the afl	afl	who founded
where did diego velazquez die	diego velazquez	diego velazquez
what is the country code for mexico	mexico	mexico
what currency do they use in switzerland	switzerland	switzerland
where is president kennedy buried	kennedy	kennedy
where was the prophet mohammed from	mohammed	mohammed from
what language do ukrainian people speak	ukrainian	ukrainian
who are the judges appointed in the supreme court	supreme court	supreme court
which country in europe has the largest land area	europe	europe
where is chris rock from	chris rock	chris rock
when was the last time the toronto maple leafs win the stanley cup	toronto maple leafs	toronto maple leafs
what kind of language do egyptian speak	egyptian	egyptian
what language do brazilians use	brazilians	brazilians
what position did vince lombardi play	vince lombardi	vince lombardi
who played stanley kowalski in a streetcar named desire movie	a streetcar	stanley kowalski
who did the voice for lola bunny	lola bunny	lola bunny
what book did charles darwin wrote in 1859	charles darwin	charles darwin
what language do serbs speak	serbs	serbs
what was the cause of death for laci peterson	laci peterson	laci peterson
what team is kris humphries play for	kris humphries	kris humphries
what movies gerard butler has been in	gerard butler	gerard butler
where did john franklin live	john franklin	john franklin
what was the last movie sean connery was in	sean connery	sean connery
what team did drogba play for	did drogba	did drogba
where did crabtree go to college	crabtree	did crabtree
where does freddie ljungberg come from	freddie ljungberg	freddie ljungberg
who is number 22 on miami dolphins	miami dolphins	miami dolphins
what state did john adams live in	john adams	john adams
what type of music did vivaldi compose	did vivaldi	did vivaldi
what team does mike fisher play for	mike fisher	mike fisher
what films has daniel craig been in	daniel craig	daniel craig
